2
The Pyramid
Medium
8 10
0 0 0 0 3 3 0 0 0 0
0 0 0 3 3 3 3 0 0 0
0 0 3 3 3 3 3 3 0 0
0 3 3 3 2 2 3 3 3 0
3 3 3 2 2 2 2 3 3 3
3 3 2 2 2 2 2 2 3 3
2 2 2 1 1 1 1 2 2 2
1 1 1 1 1 1 1 1 1 1
