5
The Fortress
Expert
8 10
4 4 0 0 0 0 0 0 4 4
4 4 4 0 0 0 0 4 4 4
3 3 3 3 0 0 3 3 3 3
3 3 3 3 3 3 3 3 3 3
2 2 2 2 2 2 2 2 2 2
2 2 2 2 2 2 2 2 2 2
1 1 1 1 1 1 1 1 1 1
1 1 1 1 1 1 1 1 1 1
