3
Checkerboard Challenge
Medium
8 10
3 0 3 0 3 0 3 0 3 0
0 3 0 3 0 3 0 3 0 3
2 0 2 0 2 0 2 0 2 0
0 2 0 2 0 2 0 2 0 2
1 0 1 0 1 0 1 0 1 0
0 1 0 1 0 1 0 1 0 1
2 0 2 0 2 0 2 0 2 0
0 0 0 0 0 0 0 0 0 0
